5 10
##########
#i.m.....#
#####.##.#
#m.m..#m.s
##########
