9 10
##########
#i.m.....#
#####.##.#
#m.m..#m.#
#.########
#......m.#
########.#
##...mmm.#
#s########
